10-Ax
----------
----------
-----A----
----------
----------
-------A--
-A------A-
----------
A--A------
------A-AA
